11111111111111111111111111111
10000000CC000000C000000000001
111110P0000000000000000000001
11CXE000000000000000000000001
11111111111111111111111111111
