111111111111111111
1000000CC000000011
100001XXX10000C001
1P0001XEX000000001
111111111111111111
