111111111111111111
1000000CC00000X011
1000011XX10000C001
1P0001E000000000X1
111111111111111111
