111111111111111111111111111111111111111111
1110000000000000CCCC0000000001111010101111
1000000000000CCCC000000000XXXX010101111111
1000000000000CCCC0000000001111010101111111
100000CC00000000CC000000000XXX0XX010111111
1000000000000CCCC0000000001111010101111111
1000000000000000C0000000001111010101111111
1000000000000CC000000000111101010111100111
1000000000000CCCC0000000001111010101111111
111111111000000000000000111111111111111111
111XXXXXP000000000000000111111111111111111
1111110000000000000000000XXXXXXXXXX1111111
111111100000000000000000000011111111111111
100000000000000000000011111111111111111111
100000EC0000000000000011111111111111111111
100000000000000000000011111111111111111111
100000000000000000000011111111111111111111
11111111111111000001000XXXXX00000111111111
1111111111100000000XXXXXXXXXXXX11111111111
111111111111111111111111111111111111111111
