111111111111111111111111111111111111111111
111111111111111111111111111111111111111111
111111111111111111111111111111111111111111
11111111111111XXXXXXXXXXXXXXXXXX1111111111
1XXXXXXXXXXXXXXXXXXXXXXXXXXXXXXXXXXX111111
1XXXXXXXXXXXXXXXXXXXXXXXXXXXXXXXXXXX111111
111111111111111111111111111111111111111111
111111111111111111111111111111111111111111
111111111111111111111111111111111111111111
111111111111111111111111111111111111111111
11111111111111111PCE1111111111111111111111
111111111111111111111111111111111111111111
111111111111111111111111111111111111111111
111111111111111111111111111111111111111111
111111111111111111111111111111111111111111
111111111111111111111111111111111111111111
111111111111111111111111111111111111111111
11111XXXXXXXXXXXXXXXXXXXXXXX11111111111111
111111111111111111111111111111111111111111
111111111111111111111111111111111111111111
111111111111111111111111111111111111111111
111111111111111111111111111111111111111111
111111111111111111111111111111111111111111
