1111111
1E0P0C1
1X00001
1111111
