111111111111111111111111111111111111111
100000000000000000000000000000000000001
100000000000000000000XXXXXXXXXXXXX00001
100000000000000000000000000000000000001
1000000XXXXXXXXXXX000000000000000000001
100000000000000000000000000000000000001
10000000XXXXXXXXXXX00000000000000000001
1000000000000000000000000XPCE0000000001
100000000000XXXXXXXX0000000000000000001
111111111111111111111111111111111111111
